###################
#.........#.......#
#.#####.#.#.#.#.#.#
#.#...#.#.#.#.#.#.#
#.#.#.#.#.#.#.#.#.#
#.#.#.#.#.#.#.#.#.#
#.#.#.#.#.#.#.#.#.#
#.#.#.#.#.#.#.#.#.#
#.#.#.#.#.#.#.#.#.#
#.#.#.#.#.#.#.#.#.#
#.................#
################### 